###################
#                 #
##### ### ### #####
##### ### ### #####
#                 #
# ### ###-### ### #
#     #     #     #
# ### ####### ### # 
#                 #
# ####### ####### #
#                 #
###################